000100000001000000000000
000100000101001000011110
011101110101000000010010
000101010100001000010010
110101010100001111111000
000100010100000000001000
000101111110101000101000
000101000010101101111000
011001001010101010101000
010001111011111000101000
000000010000000000000000
000111111110011110001000
000000010000010000001000
111100011100011110001000
000000010000000010001000
000000011110011110001000
000000000010010000001000
000111111111011111111000
011100000000010001010000
010000000010010101011100
010111000001010101010000
010101111111010101010111
010100001000010101010100
000100100010000100010000

